ACA>AAA	AGA>ATA
ACC>AAC	AGC>ATC
ACG>AAG	AGG>ATG
ACT>AAT	AGT>ATT
CCA>CAA	CGA>CTA
CCC>CAC	CGC>CTC
CCG>CAG	CGG>CTG
CCT>CAT	CGT>CTT
GCA>GAA	GGA>GTA
GCC>GAC	GGC>GTC
GCG>GAG	GGG>GTG
GCT>GAT	GGT>GTT
TCA>TAA	TGA>TTA
TCC>TAC	TGC>TTC
TCG>TAG	TGG>TTG
TCT>TAT	TGT>TTT
ACA>AGA	AGA>ACA
ACC>AGC	AGC>ACC
ACG>AGG	AGG>ACG
ACT>AGT	AGT>ACT
CCA>CGA	CGA>CCA
CCC>CGC	CGC>CCC
CCG>CGG	CGG>CCG
CCT>CGT	CGT>CCT
GCA>GGA	GGA>GCA
GCC>GGC	GGC>GCC
GCG>GGG	GGG>GCG
GCT>GGT	GGT>GCT
TCA>TGA	TGA>TCA
TCC>TGC	TGC>TCC
TCG>TGG	TGG>TCG
TCT>TTT	TGT>TCT
ACA>ATA	AGA>AAA
ACC>ATC	AGC>AAC
ACG>ATG	AGG>AAG
ACT>ATT	AGT>AAT
CCA>CTA	CGA>CAA
CCC>CTC	CGC>CAC
CCG>CTG	CGG>CAG
CCT>CTT	CGT>CAT
GCA>GTA	GGA>GAA
GCC>GTC	GGC>GAC
GCG>GTG	GGG>GAG
GCT>GTT	GGT>GAT
TCA>TTA	TGA>TAA
TCC>TTC	TGC>TAC
TCG>TTG	TGG>TAG
TCT>TGT	TGT>TAT
ATA>AAA	AAA>ATA
ATC>AAC	AAC>ATC
ATG>AAG	AAG>ATG
ATT>AAT	AAT>ATT
CTA>CAA	CAA>CTA
CTC>CAC	CAC>CTC
CTG>CAG	CAG>CTG
CTT>CAT	CAT>CTT
GTA>GAA	GAA>GTA
GTC>GAC	GAC>GTC
GTG>GAG	GAG>GTG
GTT>GAT	GAT>GTT
TTA>TAA	TAA>TTA
TTC>TAC	TAC>TTC
TTG>TAG	TAG>TTG
TTT>TAT	TAT>TTT
ATA>ACA	AAA>AGA
ATC>ACC	AAC>AGC
ATG>ACG	AAG>AGG
ATT>ACT	AAT>AGT
CTA>CCA	CAA>CGA
CTC>CCC	CAC>CGC
CTG>CCG	CAG>CGG
CTT>CCT	CAT>CGT
GTA>GCA	GAA>GGA
GTC>GCC	GAC>GGC
GTG>GCG	GAG>GGG
GTT>GCT	GAT>GGT
TTA>TCA	TAA>TGA
TTC>TCC	TAC>TGC
TTG>TCG	TAG>TGG
TTT>TCT	TAT>TGT
ATA>AGA	AAA>ACA
ATC>AGC	AAC>ACC
ATG>AGG	AAG>ACG
ATT>AGT	AAT>ACT
CTA>CGA	CAA>CCA
CTC>CGC	CAC>CCC
CTG>CGG	CAG>CCG
CTT>CGT	CAT>CCT
GTA>GGA	GAA>GCA
GTC>GGC	GAC>GCC
GTG>GGG	GAG>GCG
GTT>GGT	GAT>GCT
TTA>TGA	TAA>TCA
TTC>TGC	TAC>TCC
TTG>TGG	TAG>TCG
TTT>TGT	TAT>TCT